
* *******
*       *
*** *****
* * *   *
* * *** *
*     * *
***** * *
*       *
******* *

