#, ,#,#,#,#,#,#,#,#,#,#,#,#,#,#,#,#,#,
#, , , , , , , , , , , , , , , ,#, ,#,
#,#,#,#,#, ,#, ,#, ,#, ,#,#,#, ,#, ,#,
#, , , , , ,#, ,#, ,#, , , ,#, , , ,#,
#,#,#,#,#,#,#,#,#, ,#,#,#,#,#, ,#,#,#,
#, , , , , , , ,#, , , ,#, ,#, , , ,#,
#, ,#,#,#,#,#,#,#, ,#,#,#, ,#, ,#,#,#,
#, , , , , ,#, , , ,#, , , , , ,#, ,#,
#, ,#, ,#, ,#,#,#, ,#,#,#,#,#, ,#, ,#,
#, ,#, ,#, , , ,#, , , ,#, ,#, ,#, ,#,
#,#,#,#,#, ,#, ,#,#,#, ,#, ,#, ,#, ,#,
#, , , , , ,#, ,#, , , ,#, , , , , ,#,
#,#,#,#,#, ,#, ,#,#,#, ,#, ,#, ,#,#,#,
#, ,#, ,#, ,#, , , ,#, ,#, ,#, , , ,#,
#, ,#, ,#, ,#,#,#,#,#, ,#,#,#,#,#,#,#,
#, ,#, , , , , , , , , , , ,#, , , ,#,
#, ,#, ,#,#,#,#,#,#,#, ,#, ,#, ,#, ,#,
#, , , , , ,#, , , , , ,#, , , ,#, ,#,
#,#,#,#,#,#,#,#,#,#,#,#,#,#,#,#,#, ,#,